 --- --- --- --- --- --- --- --- --- 
|                   |               |
                                     
|           |       |       |       |
                             ---     
|           |     x |       |       |
     --- --- --- ---     ---         
|           |           |           |
                             --- --- 
|                       |         < |
 --- --- --- --- --- --- --- --- --- 